[0 ,0 ,6 ,0 ,0 ,0 ,3 ,0 ,0 ,0 ,0 ,0 ,0 ,5 ,0],
[0 ,0 ,10,0 ,0 ,0 ,0 ,0 ,0 ,0 ,0 ,0 ,0 ,2 ,0],
[6 ,10,0 ,0 ,0 ,0 ,0 ,0 ,0 ,0 ,0 ,0 ,0 ,0 ,0],
[0 ,0 ,0 ,0 ,8 ,0 ,0 ,0 ,0 ,0 ,0 ,0 ,0 ,0 ,0],
[0 ,0 ,0 ,8 ,0 ,0 ,0 ,0 ,0 ,0 ,7 ,10,12,0 ,0],
[0 ,0 ,0 ,0 ,0 ,0 ,4 ,0 ,0 ,0 ,0 ,0 ,15,0 ,0],
[3 ,0 ,0 ,0 ,0 ,4 ,0 ,7 ,0 ,0 ,0 ,0 ,0 ,0 ,0],
[0 ,0 ,0 ,0 ,0 ,0 ,7 ,0 ,3 ,0 ,0 ,0 ,0 ,0 ,0],
[0 ,0 ,0 ,0 ,0 ,0 ,0 ,3 ,0 ,1 ,0 ,1 ,0 ,0 ,2],
[0 ,0 ,0 ,0 ,0 ,0 ,0 ,0 ,1 ,0 ,0 ,0 ,0 ,0 ,5],
[0 ,0 ,0 ,0 ,7 ,0 ,0 ,0 ,0 ,0 ,0 ,0 ,0 ,0 ,0],
[0 ,0 ,0 ,0 ,10,0 ,0 ,0 ,1 ,0 ,0 ,0 ,0 ,0 ,0],
[0 ,0 ,0 ,0 ,12,15,0 ,0 ,0 ,0 ,0 ,0 ,0 ,0 ,0],
[5 ,2 ,0 ,0 ,0 ,0 ,0 ,0 ,0 ,0 ,0 ,0 ,0 ,0 ,0],
[0 ,0 ,0 ,0 ,0 ,0 ,0 ,0 ,2 ,5 ,0 ,0 ,0 ,0 ,0]